#########################################
#                                       #
# ##################################### #
#                                     # #
# ################################### # #
#                                   # # #
################################### # # #
#                                   # # #
# # # # # # #######V################# # #
# # # # # # #                         # #
# # # # # ### ####################### # #
# # # # # # #           #$            # #
# # # # ### ########################### #
# # # # # # #                         # #
# # # ### # # ####################### # #
# # # # # # # #                       # #
# # ### # # # ######################### #
# # #                                   #
# #######################################
#                                       #
#########################################
