GGGGGGGGGGGGGGGGGGGGGGGGGGGGGGGGGGGGGGGGG
G                                       G
G GGGGGGGGGGGGGGGGGGGGGGGGGGGGGGGGGGGGG G
G                                     G G
G GGGGGGGGGGGGGGGGGGGGGGGGGGGGGGGGGGG G G
G                                   G G G
GGGGGGGGGGGGGGGGGGGGGGGGGGGGGGGGGGG G G G
G                                   G G G
G G G G G G GGGGGGGGGGGGGGGGGGGGGGGGG G G
G G G G G G G                         G G
G G G G G GGG GGGGGGGGGGGGGGGGGGGGGGG G G
G G G G G G G           G$            G G
G G G G GGG GGGGGGGGGGGGGGGGGGGGGGGGGGG G
G G G G G G G                         G G
G G G GGG G G GGGGGGGGGGGGGGGGGGGGGGG G G
G G G G G G G G                       G G
G G GGG G G G GGGGGGGGGGGGGGGGGGGGGGGGG G
G G G                                   G
G GGGGGGGGGGGGGGGGGGGGGGGGGGGGGGGGGGGGGGG
G                                       G
GGGGGGGGGGGGGGGGGGGGGGGGGGGGGGGGGGGGGGGGG